NO ./pics/walls/n.xpm
SO ./pics/walls/s.xpm
WE ./pics/walls/w.xpm
EA ./pics/walls/e.xpm

F 86,125,70
C 135,206,235

1111111111111111111111111111111111111111111111111111111111111111111111111111111111111111111111111
1000000000000000000000000000000000000000000000000000000000000000000000000000000000000000000000001
1000000000000000000000000000000000000000000000000000000000000000000000000000000000000000000000001
1000000000000000000000000000000000000000000000000000000000000000000000000000000000000000000000001
1000000000000000000000011111111000011111101111111000000001111000000012110000111111100011111000001
1000000000000000000001111111000000011100001111111000000001101000000010110000110001110010111000001
1000000000000000001111111100000000010000001111111000000001101000000010110000110100011010111000001
1000000000000000111111100000000000000001111111100000000001101111111110110000110111001110111000001
1000000000000111111110000000000000000111111110000000000001100000000000110000110111100110111000001
1000000000001111111111111111111110011111111000001000000001101111111110110000110110110010111000001
1000000000001111111111111111111110011111111000111000000001101000000010110000110110011000111000001
1000000000001111111111111111111110011111111111111000040001101000000010110000110110001100111000001
1000000000000000000000000111111110000000000000000000000001121000000011110000111110000111111000001
1000000000000000000000000111111110000000000000000000000000000000000000000000000000000000000000001
1000000000000000000000000000000000000000000000000000000000000000000000000000000000000000000000001
10000000000000000000000000000000000000000000000000000N0000000000000000000000000000000000000000001
1000000000000000000000000000000000000000000000000000000000000000000000000000000000000000000000001
1111111111111111111111111111111111111111111111111111111111111111111111111111111111111111111111111
